13313131313131313131313131313131313131313131313131313131313131313114212121212121
22000000000000000000000000000000000000000000000000000000000000000020212121212121
22000000000000000000000000000000000000000000000000000000000000000020212121212121
22000000000000000000000010111200000000000000000000000000000000000030311421212121
23120000000000000000001024212312000000000000000000000000000100000000002021212121
21220000001012000000002021212122000000000000000000000002030303040000003014212121
21220000002023120000003014211332000000000000000000000000000000000000000030142121
21220000102421220000000030313200000000000000000000000000000000000000000000301421
13320000303131320000000000000000000000343333000000000000000000000000000000002021
22000000000000000000000000000000000000000000000000000000000000000000000000003014
22000000000000000000000000000000000000000000000000000000000000000000000000000020
22000000000000000000000000000000000000000000000000333433000000000000000000000020
23111111120000000000000000000000000000000000000000000000000000000000000000000020
21212121220000000000000000000000000000000000000000000000000000000000000000000020
13313131320000000000000000000000000000000000000000000000000000101111120000000020
22000000000000000000000000000000000000000000000000000000000000303131320000000020
22000000000000000000101112000000000000000000000000000000000000000000000000000020
22000000000000000000303132000000000000001011111111120000000000000000000000000020
22000000000000000000000000000000000000003031313131320000000000000000000000000020
22000000000000000000000000000000000000000000000000000000000000000010120000000020
22000000000000000000000000000000000000000000000000000000001011111124220000000020
23111111111111111111111111111111111111111111111111111111112421212121231111111124

image image:terrain
sprite @11,15 sprite:hero (u32)0
sprite @3,19 sprite:platform (u8)0 (u8)255 (u8)3 (u8)0
sprite @18,13 sprite:platform (u8)1 (u8)0 (u8)2 (u8)0
sprite @2,10 sprite:platform (u8)0 (u8)1 (u8)1 (u8)0
