13313131313131313131313131313131313131313131313131313131313131313114212121212121
22000000000000000000000000000000000000000000000000000000000000000020212121212121
22000000000000000000000000000000000000000000000000000000000000000020212121212121
22000000000000000000000010111200000000000000000000000000000000000030311421212121
23120000000000000000001024212312000000000000000000000000000000000000002021212121
21220000101112000000002021212122000000000000000000000000000000000000003014212121
21220010242123120000003014211332000000000000000000000000000000000000000030142121
13320030311421220000000030313200000000000000000000000000000000000000000000301421
22000000003031320000000000000000000000000000000000000000000000000000000000002021
22000000000000000000000000000000000000000000000000000000000000000000000000003014
22000000000000000000000000000000000000000000000000000000000000000000000000000020
22000000000000000000000000000000000000000000000000000000000000000000000000000020
23111111120000000000000000000000000000000000000000000000000000000000000000000020
21212121220000000000000000000000000000000000000000000000000000000000000000000020
13313131320000000000000000000000000000000000000000000000000000101111120000000020
22000000000000000000000000000000000000000000000000000000000000303131320000000020
22000000000000000000101112000000000000000000000000000000000000000000000000000020
22000000000000000000303132000000000000001011111111120000000000000000000000000020
22000000000000000000000000000000000000003031313131320000000000000000000000000020
22000000000000000000000000000000000000000000000000000000000000000000000000000020
22000000000000000000000000000000000000000000000000000000000000000000000000000020
23111111111111111111111111111111111111111111111111111111111111111111111111111124

image image:terrain
sprite @11,15 sprite:hero (u32)0
