21212121212121212121212121212121212121212121212121212121212121212121212121212121
13313131313131313131313131313131313131313131313131313131313131313131313131313114
22000000000000000000000000000000000000000000000000000000000000000000000000000020
22000000000000000000000000000000000000000000000000000000000000000000000000000020
22000000000000505152000000000000000000005d5e009091920000009697000000000000000020
22000000000000600062636465666768696a6b6c6d6e00a000a2a3a4a5a6a7a8a900000000000020
22000000000000707172737475767778797a7b7c7d0000b0b1b2b3b4b5b6b7b8b900000000000020
22000000000000808182838485868788898a8b8c8d0000c0c1c2c3c4c5c6c7c8c900000000000020
22000000000000000000000000000000000000000000000000000000000000000000000000000020
22000000000000000000000000000000000000000000000000000000000000000001000000000020
22000000000000000000000000000000000000000000000000000000000000020303030400000020
23111111111111111111111111111111120000000000000000000000000000000000000000000020
21212121212121212121212121212121220000000000000000000000000000000000000000000020
21212121212121212121212121212121220000000000000000000000101111111111111111111124
21212121212121212121212121212121220000000000000000000000202121212121212121212121
21212121212121212121212121212121220000000000000000001011242121212121212121212121
21212121212121212121212121212121220000000000000000002021212121212121212121212121
21211331313131313131313131311421220000000000000010112421212121212121212121212121
212122d0d1d2d3d4d5d6d7d8d9da2021220000000000000020212121212121212121212121212121
212122e0e1e2e3e4e5e6e7e8e9ea2021220000000000101124212121212121212121212121212121
21212311111111111111111111112421220505050505202121212121212121212121212121212121
21212121212121212121212121212121231111111111242121212121212121212121212121212121

image image:terrain
sprite @12,10 sprite:hero (u32)0
fake
