13313131313131313131313131313131313131313131313131313131313131313114212121212121
22000000000000000000000000000000000000070707000000000000000000000020212121212121
22000000000000000000000000000000000000000000000000000000000000000020212121212121
22000000000000000000000010111200000000000000000000000000000000000030311421212121
23120000000000000000001024212312060000000000000000000000000100000000002021212121
21220000001012000000002021212122060000000000000000000002030303040000003014212121
21220000002023120000003014212122060000000000000000000000000000000000000030142121
21220000102421220000000030313132060000000000000000000000000000000000000000301421
13320000303131320000000000000000000000343333000000000000000000000000000000002021
22000000000000000000000000000000000000000000000000000000000000000000000000003014
22000000000000000000000000000000000000000000000000000000000000000000000000000820
22000000000000000000000000000000000000000000000000333433000000000000000000000820
23111111120000000000000000000000000000000000000000000000000000000000000000000820
21212121220000000000000000000000000000000000000000000000000000000000000000000820
13313131320000000000000000000000000000000000000000000000000000101111120000000820
22434645490000000000000000000000000000000000000000000000000000303131320000000820
22000000000000000000101112000000000000000000000000000000000000000000000000000820
22000000000000000000303132000000000000001011111111120000000000000000000000000820
22000000000000000000000000000000000000003031313131320000000000000000000000000820
22000000000000000000000000000000000000000000000000000000000000000010120000000820
22000000000000000000000000000000050500000000000000000000001011111124220000000820
23111111111111111111111111111111111111111111111111111111112421212121231111111124

image image:terrain
sprite @11,15 sprite:hero (u32)0
sprite @9,6 sprite:platform (u8)0 (u8)255 (u8)3 (u8:timescale)normal
sprite @18,13 sprite:platform (u8)1 (u8)0 (u8)2 (u8:timescale)stop
sprite @2,10 sprite:platform (u8)0 (u8)1 (u8)1 (u8:timescale)slow
sprite @6,1 sprite:flamethrower 0x02 (u8:timescale)normal 0x80 3
sprite @6,20 sprite:flamethrower 0x08 (u8:timescale)normal 0x80 3
sprite @32,19 sprite:flamethrower 0x10 (u8:timescale)normal 0x80 3
sprite @15,20 sprite:flamethrower 0x40 (u8:timescale)normal 0x80 3
sprite @13,2 sprite:fryguy 0x10 (u8:timescale)normal 0x0000
sprite @29,6 sprite:motionsensor (u32)0
sprite @4,20 sprite:passgate (u32)3659
sprite @4,16 sprite:passgate (u32)3659
sprite @4,17 sprite:passgate (u32)3659
sprite @4,18 sprite:passgate (u32)3659
sprite @4,19 sprite:passgate (u32)3659
sprite @15,8 sprite:password (u8)0 (u8:timescale)normal 0x0000
sprite @12,8 sprite:password (u8)0 (u8:timescale)normal 0x0000
sprite @13,8 sprite:password (u8)0 (u8:timescale)normal 0x0000
sprite @14,8 sprite:password (u8)0 (u8:timescale)normal 0x0000
