13313131313131313131313131313131311421211331313131313131313131313131313131311421
22000000000000000000000000000000003031313207070707070707070707070707070707072021
22000000000000000000000000000000000000000000000000000000000000000000000000002021
22000000000000000000000000000000000000000000000000000000000000000000000000002021
22000000101112000000000000000000000000000000000000000000000000000000000000002021
22000000303132000000000000000000000000000000000000000000000010111111120000002021
22000000000000000000000000000000000000000000000000000000000020133131320000003014
22000000000000000000000000000000000000000000000000000000000020220000000000000020
22000000000000000000000000000000000000000000000000000000000020220000000000000020
22000000000000000000000000000000000000000000000000000000000020220000000000000020
22000000000000000000000000000000000000000000000000000000000020220000000000000020
22000000000000000000000000000000000000000000000000000000000020220000000000000020
22000000001012000000000000000000101200101200000000000000000020220000000000000020
22000000002023111111111111111111242311242311111111111111111124220001000000000020
22000000003031313131313131313131313131313131313131313131313131320203040000000020
22000000000000000000000000000000000000000000000000000000000000000000000000000020
22000000000000000000000000000000000000000000000000000000000000000000000000000020
22000000000000000000000000000000000000000000000000000000000000000000000000000020
22000000000000000000000000000000000000000010111111111111111111120000000000000020
22000000000000000000000000001011111111111124212121212121212121220000000000000020
22000000000000101111111111112421212121212121212121212121212121220505050505050520
23111111111111242121212121212121212121212121212121212121212121231111111111111124

image image:terrain
sprite @8,5 sprite:platform 1 0 3 (u8:timescale)normal
sprite @5,3 sprite:hero (u32)0
sprite @2,18 sprite:platform 0 255 3 (u8:timescale)stop
sprite @38,7 sprite:flamethrower 0x10 (u8:timescale)infinite 0x80 6
sprite @23,12 sprite:fryguy 0x08 (u8:timescale)normal 0x0000
sprite @11,12 sprite:fryguy 0x08 (u8:timescale)normal 0x0000
sprite @21,12 sprite:flamethrower 0x08 (u8:timescale)normal 0x80 3
sprite @18,12 sprite:flamethrower 0x40 (u8:timescale)normal 0x80 3
sprite @15,12 sprite:flamethrower 0x10 (u8:timescale)normal 0x80 3
sprite @36,5 sprite:platform 0 1 3 (u8:timescale)stop
