21212121212113313131313131313131313131313131313131313114212121212121212121212121
13313131313132000000000000000000000000000000000000000030313131313131313131313114
22000000000000000000000000000000000000000000000000000000000000000000000000000020
22000000000000000000000000000000000000000000000000000000000000000000000000000020
22000000000000000000000000000000000000000000000000000000000000000000000000000020
22000000000010120000000000000000000000000000000000001011111205050505000000000020
22000000000020231111111111111111111111111111111111112421212311111112000000101124
22000000000020133131313131313131313131313131313131313131313131311422000000303114
22000000000020220000000000000000000044454600000000000000000000002022000000000020
22000000000020220000000000000000000000000000000000000000000000002022000000000020
22000000000020220000000000000000000000000000000000000000000000002023111200000020
22000000000020220000000000000000000000000000000000000000000000003031142200000020
22000000000020220000000000000000000000000000000000000000000000000000202200000020
22000000000020220000000000000000000000000000000000000000000000000000303200000020
22000000000020231111111111111111111111111111111111111111120000000000000000000020
22000000000030313131313131313131313131313131313131313131320000000000000000000020
22000000000000000000000000000000000000000000000000000000000000000000000000000020
22000000000000000000000000000000000000000000000000000000000000000000000000000020
22000000000000000000000000000000000000000000000000000000000000000000000000000020
22000000000000000000000000000000000000000000000000000000000000000000000000000020
22050505050510111111111111111111111111111111111111111111111111120505050505050520
23111111111124212121212121212121212121212121212121212121212121231111111111111124

image image:terrain
sprite @8,13 sprite:conveyor 21 0x08 (u8:timescale)stop 0x00
sprite @9,12 sprite:princess (u32)0
sprite @27,8 sprite:flamethrower 0x02 (u8:timescale)normal 0x80 4
sprite @12,8 sprite:flamethrower 0x02 (u8:timescale)normal 0x80 4
sprite @19,12 sprite:passgate (u32)456
sprite @19,9 sprite:passgate (u32)456
sprite @19,10 sprite:passgate (u32)456
sprite @19,11 sprite:passgate (u32)456
sprite @14,12 sprite:platform 0 255 3 (u8:timescale)stop
sprite @33,12 sprite:flamethrower 0x10 (u8:timescale)normal 0x40 9
sprite @37,18 sprite:platform 0 255 3 (u8:timescale)normal
sprite @3,5 sprite:platform 0 1 3 (u8:timescale)stop
sprite @10,19 sprite:hero (u32)0
sprite @14,3 sprite:password 0 (u8:timescale)normal 0x0000
sprite @12,3 sprite:password 0 (u8:timescale)normal 0x0000
sprite @13,3 sprite:password 0 (u8:timescale)normal 0x0000
sprite @14,5 sprite:fryguy 0x08 (u8:timescale)normal 0x0000
