13313131313131313131313131313131313131311413313131313131313131313131313131313114
22000000000000000000000000000000000000002022000000000000000000000000000000000020
22000000000000000000000000000000000000002022000000000000000000000000000000000020
22000000000000000000000000000000000000002022000000000000000000000000000000000020
22000000000000000000000000000000000000002022000000000000000000000000000000000020
22000000000000000000000000000000000000002022000000000000000000000000000000000020
22000000000000000000000000000000000000002022000000000000000000000000000000000020
22000000000010111111120000000000000000002022000000000000000000000000000000000020
22000000000030313131320000000000000000002022000000000000000000000000000000000020
22000000000000000000000000000000000000002022000000000000000000000000000000000020
22000000000000000000000000000000000000002022000000000000000000000000000000000020
22000000000000000000000000000000000000002023111111111111111111111111111111111124
22000000000000000000000000000000000000003031313131313131313131313131313131313114
22000000000000000000000000000000000000000000000000000000000000000000000000000020
22340000000000000000000000000000000000000000000000000000000000000000000000101124
22000000000000000000000000000000000000000000000000000000000000000000000000303114
22000000000000000000000000000000000000000000000000000000000000000000000000000020
23111200000000000000000000000000000000010000000000000000000000003433000000000020
13313200000000000034343333000000000203030304000000000000000000000000000000000020
22000000000000000000000000000000000000000000000000000000000000000000000000000020
22000000000000000000000000000000000000000000000000000000000000000000000000000020
23111111111111111111111111111111111111111111111111111111111111111111111111111124

image image:terrain
sprite @6,20 sprite:hero (u32)0
sprite @8,9 sprite:motionsensor (u32)0
sprite @26,13 sprite:platform (u8)1 (u8)0 (u8)3 (u8:timescale)normal
sprite @6,14 sprite:flamethrower 0x40 (u8:timescale)stop 0x80 0x00
