21212121212121212121212121212121212121212121212121212121212121212121212121212121
21212121212121212121212121212121212121212121212121212121212121212121212121212121
21212121212121212121212121212121212121212121212121212121212121212121212121212121
21212121212121212121212121212121212121212121212121212121212121212121212121212121
21212121212121212121212121212121212121212121212121212121212121212121212121212121
21212121212121211331313131313131313114212121212121212121212121212121212121212121
21212121212121212200000000000000000030313131313131313131142121212121212121212121
21212121212121212200000000000000000000000000000000000000303131142121212121212121
21212121212121212200000100000000000000000000000000000000000000202121212121212121
21212121212121212202030303040000000000000000000000000000000000202121212121212121
21212121212121212311111111111111111111111112000000000000000000202121212121212121
21212121212121211331313131313131313131311423111111120000000000202121212121212121
21212121212121212200000000000000000000003031313131320000000000202121212121212121
21212121212121212200000000000000000000000000000000000000000000202121212121212121
21212121212121212200000000000000000000000000000000000000000000202121212121212121
21212121212121212311111111111111111111111111111111111111111111242121212121212121
21212121212121212121212121212121212121212121212121212121212121212121212121212121
21212121212121212121212121212121212121212121212121212121212121212121212121212121
21212121212121212121212121212121212121212121212121212121212121212121212121212121
21212121212121212121212121212121212121212121212121212121212121212121212121212121
21212121212121212121212121212121212121212121212121212121212121212121212121212121
21212121212121212121212121212121212121212121212121212121212121212121212121212121

image image:terrain
sprite @11,14 sprite:hero (u32)0
sprite @25,10 sprite:flamethrower 0x40 (u8:timescale)infinite 0x80 2
sprite @15,14 sprite:flamethrower 0x40 (u8:timescale)infinite 0x80 2
