21212121212121212121212121212121212121212121212121212121212121212121212121212121
21212121212121212121212121212121212121212121212121212121212121212121212121212121
21212121212121212121212121212121212121212121212121212121212121212121212121212121
21212121212121212121212121212121212121212121212121212121212121212121212121212121
21133131313131313131313131313131313131313131313131313131313131313131313131311421
21220000000000000000000000000000000000000000000000000000000000000000000000002021
21220000000000000000000000000000000000000000000000000000000000000000000000002021
21220000000000000000000000000000000000000000000000000000000000000000000000002021
21220000000000000000000000000000000000000000000000000000000000000000000000002021
21220000000000000000000000000000000000000000000000000000000000000000000000002021
21231111120000000000000000000000000000000000000000000000000000000100000000002021
21212121220000000000000000000000000000000000000000000000000002030303030400002021
21212121220000000000000000000000000000000000000000000000000000000000000000002021
21212121220000000000000000000000000000000000000000000000000000000000000000002021
21212121231111120000000000000000000000000000000000000000000000000000000000002021
21212121212121220000000000000000000000000000000000000000000000000000000000002021
21212121212121220000000000000000000000000000000000000000000000000000000000002021
21212121212121220505050505050505050505050505050505050505050505050505050505052021
21212121212121231111111111111111111111111111111111111111111111111111111111112421
21212121212121212121212121212121212121212121212121212121212121212121212121212121
21212121212121212121212121212121212121212121212121212121212121212121212121212121
21212121212121212121212121212121212121212121212121212121212121212121212121212121

image image:terrain
sprite @3,9 sprite:hero (u32)0
sprite @24,12 sprite:platform 0xff 0 3 (u8:timescale)stop
