21212121212121133131313131313131313131313131313131313131313131311421212121212121
21212121212121220600000000000000000000000000000000000000000000082021212121212121
21212121212121220600000000000000000000000000000000000000000000082021212121212121
21212121212121220600000000000100000000000000000000000000000000082021212121212121
21212121212121220600000002030303040000000000000000000000000000082021212121212121
21212121212121220600000000000000000000000000000000000000000000082021212121212121
21212121212121220600000000000000000000000000000000000000000000082021212121212121
21212121212121220600000000000000000000000000000000000000000000082021212121212121
21212121212121220600000000000000000000000000000000000000000000082021212121212121
21212121212121220600000000000000000000000000000000000000000000082021212121212121
21212121212121220600000000000000000000000000000000000000000000082021212121212121
21212121212121220600000000000000000000000000000000000000000000082021212121212121
21212121212121220600000000000000000000000000000000000000000000082021212121212121
21212121212121220600000000000000000000000000000000000000000000082021212121212121
21212121212121220600000000000000000000000000000000000000000000082021212121212121
21212121212121220600000000000000000000000000000000000000000000082021212121212121
21212121212121220600000000000000000000000000000000000000000000082021212121212121
21212121212121220600000000000000000000000000000000000000000000082021212121212121
21212121212121220600000000000000000000000000000000000000000000082021212121212121
21212121212121220600000000000000000000000000000000000000000000082021212121212121
21212121212121220600000000000000000000000000000000000000000000082021212121212121
21212121212121231111111111111111111111111111111111111111111111112421212121212121

image image:terrain
sprite @20,20 sprite:hero (u32)0
sprite @15,6 sprite:platform 1 0 3 (u8:timescale)normal
sprite @15,18 sprite:platform 1 0 3 (u8:timescale)normal
sprite @15,16 sprite:platform 1 0 3 (u8:timescale)normal
sprite @15,14 sprite:platform 1 0 3 (u8:timescale)normal
sprite @15,12 sprite:platform 1 0 3 (u8:timescale)normal
sprite @15,10 sprite:platform 1 0 3 (u8:timescale)normal
sprite @15,8 sprite:platform 1 0 3 (u8:timescale)normal
