13313131313131313131313131142113313131313131313131313131313131313131313131313114
22000000000000000000000000202122000000000000000000000000000000000000000000000020
22000000000000000000000000202122000000000000000000000000000000000000000000000020
22000000000000000000000000202122000000000000000000000000000000000000000000000020
22000000000000000000000000202122000000000010111111111111111111111111111200000020
22000000000000000000151700202122000000000020133131313131313131313131313200000020
22000000000000000000000000202122000000000020220000000000000000000000000000000020
22000000000000000000000000202122000000000020220000000000000000000000000000000020
22000000000000000000000000202122000000000020220000000000000000000000000000000020
22000015170000000000000000202122000000000020220000000000000000000000000000000020
22000000000000000010111111242122000000000020220000000000000000000000000000000020
22000000000000000030313131313132000000000020220000000000000000000000000000000020
22000000000000000000000000000000000000000020220000000000000000000000000000000020
22000000000000000000000000000000000000000020220000000000000000000000000000000020
22000000000000000000000000000000000000000020220000000000000000000000000000000020
22000000001011111111111111111200000000000020220000101111111111111112000000000020
22000000003031313131313131142200000000000030320000202113313131311422000000000020
22000047424548000000000000202200000000000000000000202122000000003032000000000020
22000000000000000000000000202312000000000000000000202122000000000000000000101124
22000000000000000000010000202122000000000000000000202122000000000000000000202121
22000000000000000203030304202122000000000000000000202122000000000000000000202121
23111111111111111111111111242123111111111111111111242123111111111111111111242121

image image:terrain
sprite @2,20 sprite:hero (u32)0
sprite @4,20 sprite:passgate (u32)7258
sprite @4,18 sprite:passgate (u32)7258
sprite @4,19 sprite:passgate (u32)7258
sprite @31,17 sprite:password (u8)0 (u8:timescale)normal 0x0000
sprite @28,17 sprite:password (u8)0 (u8:timescale)normal 0x0000
sprite @29,17 sprite:password (u8)0 (u8:timescale)normal 0x0000
sprite @30,17 sprite:password (u8)0 (u8:timescale)normal 0x0000
sprite @20,11 sprite:flamethrower 0x10 (u8:timescale)normal 0x40 4
sprite @16,9 sprite:flamethrower 0x08 (u8:timescale)normal 0x40 4
sprite @16,5 sprite:flamethrower 0x08 (u8:timescale)normal 0x40 4
sprite @20,7 sprite:flamethrower 0x10 (u8:timescale)normal 0x40 4
sprite @18,14 sprite:platform 0 0xff (u8)3 (u8:timescale)normal
