21212121212121212121212121212121212121212121212121212121212121212121212121212121
21212121212121211331313131311413313131313114133131313131142121212121212121212121
21212121212121212200000000002022000000000020220000000000202121212121212121212121
21212121212121212200000000002022000000000020220000000000202121212121212121212121
21212121212121212200000000002022000000000030320000000000202121212121212121212121
21212121212121212200000000002022000000000000000000000000202121212121212121212121
21212121212121212200000000002022000000000000000000000000201331313131313131313114
21212121212121212200000000002022000000000000000000000000202200000000000000000020
21212121212121212200000000002022000000000000000000000000202200000000000000000020
21212121212121212200000000002022000000000010120000000000202200000000000000000020
21212121212121212200000000002022000000000020220000000000303200000000000000000020
21212121212121212200000000003032000000000020220000000000000000000000000000000020
13313131313131313200000000000000000000000020220000000000000000000000010000000020
22000000000000000000000000000000000000000020220000000000000000000203030304000020
22000000000000000000000000000000000000000020220000000000000000000000000000000020
22000000000000000000000000000000000000000020220000000000101200000000000000000020
22000000000000000000000000001012000000000020220000000000202200000000000000000020
22000000000000000000000000002022000000000020220000000000202200000000000000000020
22000000000000000000000000002022000000000020220000000000202200000000000000000020
23111111111111111200000000002022000000000020220000000000202200000000000000000020
21212121212121212200000000002022050505050520220000000000202205050505050505050520
21212121212121212311111111112423111111111124231111111111242311111111111111111124

image image:terrain
sprite @3,18 sprite:hero (u32)0
sprite @25,11 sprite:platform 0 0xff (u8)3 (u8:timescale)normal
sprite @11,17 sprite:platform 0 0xff (u8)3 (u8:timescale)stop
sprite @18,7 sprite:platform 0 0xff (u8)3 (u8:timescale)stop
sprite @25,10 sprite:fryguy (u8)0x08 (u8:timescale)stop 0x0000
