21212121212121212121212113313131313131313131313131141331313114212121212121212121
21212121212121212121212122000000000000000000000000303200000020212121212121212121
21212121212121211331313132000000000000000000000000000000000020212121212121212121
21212121212121212200000000000000000000000000000000000000000020212121212121212121
21212121133131313200000000000000000000000000000000000000000020212121212121212121
21212121220000000000000000000000000000000000000000101200000020212121212121212121
13313131320000000000000000000000000000000000000000202200000020212121212121212121
22000000000000000000000000000000000000000000000000202200000020133131313131313114
22000000000000000000000000000000000000000000000000202200000020220000000000000020
22000000000000000000000000000000000000000000000000202200000020220000000000000020
22000000000000000000000000000000000000000000000000202200000020220000000000000020
22000000000000000000000000000000000000000000000000202200000030320000000000000020
22000000000000000000000000000000000000000000000000202200000000000000000001000020
22000000000000000000000000000000000000000000000000202200000000000000020303030420
22000000000000000000000000000000000000000000000000202200000000000000000000000020
23111111120000000000000000000000000000000000000000202200000000000000000000000020
21212121220000000000000000000000000000000000000000202200000015161616170000000020
21212121220000000000000000000000000000000000000000303200000000000000000000000020
21212121220000000000000000000000000000000000000000000000000000000000000000000020
21212121220000000000000000000000000000000000000000000000000000000000000000000020
21212121220505050505050505050505050505050505050505050505050505050505050505050520
21212121231111111111111111111111111111111111111111111111111111111111111111111124

image image:terrain
sprite @19,6 sprite:conveyor 4 0x10 (u8:timescale)normal 0x00
sprite @2,14 sprite:hero (u32)0
sprite @7,14 sprite:conveyor 4 0x10 (u8:timescale)normal 0x00
sprite @13,10 sprite:conveyor 4 0x10 (u8:timescale)normal 0x00
sprite @30,15 sprite:flamethrower 0x40 (u8:timescale)normal 0x20 3
sprite @28,9 sprite:platform 0 1 (u8)3 (u8:timescale)normal
sprite @30,17 sprite:flamethrower 0x10 (u8:timescale)infinite 0x80 3
