21212121211331313131313131311413313131313131313131313131313114212121212121212121
13313131313200000000000000002022000000000000000000000000000030313131313131313114
22000000000000000000000000002022000000000000000000000000000000000000000000000020
22000000000000000000000000003032000000000000000000000000000000000000000000000020
22000000000000000000000000000000000000000000000000000000000000000000000000000020
22000000101200000000000000000000000000000000000000000000000000000000000000000020
22000000202311111111111200000000000000000000000000000000000000000000000000000020
22000000303131313131142311111112000000000000000000000000000000000000000000000020
22000000000000000000303131311422000000000000000000000000000000000000000000000020
22000000000000000000000000002022000000000000000000000000000000000000000000000020
22000000000000000000000000002022000000000000000000000000000000000000010000000020
22000000000000000000000000002022000000000000000000000000000000000203030304000020
22000000000000000000000000002022000000000000000000000000000000000000000000000020
22000000000000000010120000002022000000000010120000000000000000000000000000000020
22000000101111111124220000002023111111111124220000000000000010111111111111111124
22000000303131313131320000003031313131313131320000000000000030313131142121212121
22000000000000000000000000000000000000000000000000000000000000000000301421212121
22000000000000000000000000000000000000000000000000151617000000000000002021212121
22000000000000000000000000000000000000000000000000000000000000000000002021212121
23111111111111111111111111111111111112000000000000000000000000000000102421212121
21212121212121212121212121212121212123111111111200000000001011111111242121212121
21212121212121212121212121212121212121212121212311111111112421212121212121212121

image image:terrain
sprite @26,1 sprite:motionsensor (u32)0
sprite @12,14 sprite:platform 0 1 (u8)3 (u8:timescale)normal
sprite @4,18 sprite:hero (u32)0
sprite @7,13 sprite:fryguy 0x08 (u8:timescale)normal 0x0000
sprite @2,14 sprite:platform 0 255 (u8)3 (u8:timescale)stop
