21212121212121212121212121212121212121212121212121212121212121212121212121212121
21212121212121212121212121212121212121212121212121212121212121212121212121212121
21212121212121212121212121212121212121212121212121212121212121212121212121212121
21212121212121212121212121212121212121212121212121212121212121212121212121212121
21212121212121212121212121212121212121212121212121212121212121212121212121212121
21212121212121212121212121212121212121212121212121212121212121212121212121212121
21212121212113313131313131313131313131313131313131313131313131313114212121212121
21212121211332000000000000000000000000000000000000000000000000000030142121212121
21212121133200000000000000000000000000000000000000000000000000000000301421212121
21212121220000000000000000000000000000000000000000000000000000000000002021212121
21212121220000000000000000000000000000000000000000000000000000000000002021212121
21212121220000000000000000000000000000000000000000000000000000000000002021212121
21212121220000000000000000000000000000000000000000000000000000000000002021212121
21212121220000000000000000000000000000000000000000000000000000000100002021212121
21212121231111111200000000000000000000000000000000000000000002030303042021212121
21212121212121212311111111111111111111111111111111111111111111111111112421212121
21212121212121212121212121212121212121212121212121212121212121212121212121212121
21212121212121212121212121212121212121212121212121212121212121212121212121212121
21212121212121212121212121212121212121212121212121212121212121212121212121212121
21212121212121212121212121212121212121212121212121212121212121212121212121212121
21212121212121212121212121212121212121212121212121212121212121212121212121212121
21212121212121212121212121212121212121212121212121212121212121212121212121212121

image image:terrain
sprite @9,14 sprite:conveyor 21 0x10 (u8:timescale)normal 0x00
sprite @9,7 sprite:flamethrower 0x02 (u8:timescale)normal 0x80 6
sprite @13,7 sprite:flamethrower 0x02 (u8:timescale)normal 0x80 6
sprite @17,7 sprite:flamethrower 0x02 (u8:timescale)normal 0x80 6
sprite @21,7 sprite:flamethrower 0x02 (u8:timescale)normal 0x80 6
sprite @25,7 sprite:flamethrower 0x02 (u8:timescale)normal 0x80 6
sprite @29,7 sprite:flamethrower 0x02 (u8:timescale)normal 0x80 6
sprite @6,13 sprite:hero (u32)0
