21212121212121212121212121212121212121212121212121212121212121212121212121212121
21212121212121212121212121212121212121212121212121212121212121212121212121212121
21212121212121212121212121212121212121212121212121212121212121212121212121212121
21212121212121212121212121212121212121212121212121212121212121212121212121212121
21212121212121212121212121212121212121212121212121212121212121212121212121212121
21212121212121212121212121212121212121212121212121212121212121212121212121212121
21211331313131313131313131313131313131313131313131313131313131313131313131142121
21133200000000000000000000000000000000000000000000000000000000000000000000301421
13320000000000000000000000000000000000000000000000000000000000000000000000003014
22000000000000000000000000000000000000000000000000000000000000000000000000000020
22000000000000000000000000000000000000000000000000000000000000000000000000000020
22000000000000000000000000000000000000000000000000000000000000000000000000000020
22000000000000000000000000000000000000000000000000000000000000000000000000000020
22000000000000000000000000000000000000000000000000000000000000000000000001000020
23111111120000000000000000000000000000000000000000000000000000000000020303030420
21212121231111111111111111111111111111111111111111111111111111111111111111111124
21212121212121212121212121212121212121212121212121212121212121212121212121212121
21212121212121212121212121212121212121212121212121212121212121212121212121212121
21212121212121212121212121212121212121212121212121212121212121212121212121212121
21212121212121212121212121212121212121212121212121212121212121212121212121212121
21212121212121212121212121212121212121212121212121212121212121212121212121212121
21212121212121212121212121212121212121212121212121212121212121212121212121212121

image image:terrain
sprite @5,14 sprite:conveyor 29 0x10 (u8:timescale)normal 0x00
sprite @33,7 sprite:flamethrower 0x02 (u8:timescale)normal 0x80 6
sprite @5,7 sprite:flamethrower 0x02 (u8:timescale)normal 0x80 6
sprite @9,7 sprite:flamethrower 0x02 (u8:timescale)normal 0x80 6
sprite @13,7 sprite:flamethrower 0x02 (u8:timescale)normal 0x80 6
sprite @17,7 sprite:flamethrower 0x02 (u8:timescale)normal 0x80 6
sprite @21,7 sprite:flamethrower 0x02 (u8:timescale)normal 0x80 6
sprite @25,7 sprite:flamethrower 0x02 (u8:timescale)normal 0x80 6
sprite @29,7 sprite:flamethrower 0x02 (u8:timescale)normal 0x80 6
sprite @2,13 sprite:hero (u32)0
